--....--.
.--..---.
...---...
.........
.........
.........
.........
....@....